11111111111111111111
10000P000000C0000001
100000C0000000000C01
10000000000000000001
10000000000000000001
10000000000000000001
10000000000000000001
10000000000000000001
10000000000000000001
10000000000000000001
10000000000000000001
10000000000000000001
10000000000000000001
10000000000000000001
10000000000000000001
10000000000111111111
10000000000100000001
10000000000100000001
1110000000010E000C01
100000C0000000000C01
11111111111111111111