1111111111111111111111111111
100001P000000000000000000001
1000011111111000000000100001
1000000000000000000000000001
1000000000000001111100000001
100C00000000000100C100000001
1000000100000001000000100001
1000000100000001000000000001
10C0111100000001111111111111
100010000000000000001E000001
1111100000111000000010000001
10000000001C0000000000000001
10C00000001000000000000000C1
1111111111111111111111111111