111111111111
10P000000001
100C00111111
100C000000E1
111111111111